s***#****#******
###*#**#*#***#**
****#**#*#**#***
***###**##*#*#**
*#*****#*****#**
**###**#*#*##***
#*****#***#*****
**#**#**#***#***
*#*****#*#*#****
******#***#*****
***#****#****##g