s□□□■□□□□■□□□□□□
■■■□■□□■□■□□□■□□
□□□□■□□■□■□□■□□□
□□□□□□■□□□□■□□■□
□□□■■■□□■■□■□■□□
□■□□□□□■□□□□□■□□
□□■■■□□■□■□■■□□□
■□□□□□■□□□■□□□□□
□□■□□■□□■□□□■□□□
□■□□□□□■□■□■□□□□
□□□□□□■□□□■□□□□□
□□□■□□□□■□□□□■■g